###################
###################
###################
###################
xxxxxxxxxxxxxxxxxxx
xc   x       x    x
x xx x xxxxx x xx x
x x      i      x x
x x xx xxDxx xx x x
x      xrobx      x
x x xx xxxxx xx x x
x x             x x
x xx x xxxxx x xx x
x    x   p   x   cx
xxxxxxxxxxxxxxxxxxx
###################
###################
###################
###################