xxxxxxxxxxxxxxxxxxx
x        x        x
xcxx xxx x xxx xxcx
x                 x
x xx x xxxxx x xx x
x    x       x    x
xxx xxx xxx xxx xxx
##x x         x x##
xxx x xxxdxxx x xxx
      xri obx
xxx x xxxxxxx x xxx
##x x         x x##
xxx x xxxxxxx x xxx
x        x        x
x xx xxx x xxx xx x
x  x     P     x  x
xx x x xxxxx x x xx
x    x   x   x    x
xcxxxxxx x xxxxxxcx
x                 x
xxxxxxxxxxxxxxxxxxx